11111111111111111111
1    1   1   1  1  1
1  5 1 6 1 7 1 71  1
1    1   1   1  1  1
11111111111111111111
1  1  1  1  1  1   1
1 41 51 51 61 71 7 1
1  1  1  1  1  1   1
11111111111111111111
1 3 1 4 1 51 61  7 1
1   1   1  1  1    1
11111111111111111111
1 21 31 4 1  5 1 6 1
1  1  1   1    1   1
11111111111111111111
1  1  1  1   1  1  1
1  1 21 31 4 1 51 61
1  1  1  1   1  1  1
1  1  1  1   1  1  1
11111111111111111111
