11111111111111111111
1    1   1   1  1  1
1  5 + 6 + 7 + 7+ o1
1    1   1   1  1  1
11+1+111+11+11+111+1
1  1  1  1  1  1   1
1 4+ 5+ 5+ 6+ 7+ 7 1
1  1  1  1  1  1   1
11+11+1+11+11+111+11
1 3 + 4 + 5+ 6+  7 1
1   1   1  1  1    1
11+11+1+1+111+111+11
1 2+ 3+ 4 +  5 + 6 1
1  1  1   1    1   1
11+11+11+111+1+111+1
1  1  1  1   1  1  1
1 i+ 2+ 3+ 4 + 5+ 61
1  1  1  1   1  1  1
1  1  1  1   1  1  1
11111111111111111111
