11111111111111111111
1    1   1   1  1  1
1    1   1   1  1 o1
1    1   1   1  1  1
11111111111111111111
1  1  1  1  1  1   1
1  1  1  1  1  1   1
1  1  1  1  1  1   1
11111111111111111111
1   1   1  1  1    1
1   1   1  1  1    1
11111111111111111111
1  1  1   1    1   1
1  1  1   1    1   1
11111111111111111111
1  1  1  1   1  1  1
1 i1  1  1   1  1  1
1  1  1  1   1  1  1
1  1  1  1   1  1  1
11111111111111111111
