1111111111
1  1  1  1
1 1+ 2+ o1
1  1  1  1
11+11+11+1
1   1    1
1 i +  1 1
1   1    1
1   1    1
1111111111
