0, 0, 5, 6
4, 0, 6, 6
0, 5, 4, 5
3, 5, 4, 5
6, 5, 4, 5
