1111111111
1  1  1  1
1  1  1  1
1  1  1  1
1111111111
1   1    1
1   1    1
1   1    1
1   1    1
1111111111
