1111111111
1  1  1  1
1  1  1 o1
1  1  1  1
1111111111
1   1    1
1 i 1    1
1   1    1
1   1    1
1111111111
