111111111111111111111111111111
1    1   1  1   1  1  1  1   1
1  1 1 2 1 31 4 1 51 51 61 7 1
1    1   1  1   1  1  1  1   1
111111111111111111111111111111
1   1  1  1   1  1  1  1  1  1
1   1 11 21 3 1 41 51 51 61 71
1   1  1  1   1  1  1  1  1  1
111111111111111111111111111111
1  1   1  1  1    1    1  1  1
1 11 2 1 31 41  5 1  5 1 61 71
1  1   1  1  1    1    1  1  1
1  11111  1  11111111111111111
1111 3 1111111  5 1 6 1 71   1
1 21   1 41 51    1   1  1 8 1
1  11111  1  1111111111111   1
1111 4 1111111  6 1 7 1 811111
1 31   1  1 51    1   1  1 9 1
1  11111 51  1111111111111   1
1111   1  1111    1   1  11111
1 41 5 1  1 51  6 1 7 1 81 9 1
1  1   1111  1    1   1  1   1
11111111  1111111111111  11111
1  1   1 51  1    1   1111   1
1 51 5 1  1 61  7 1 8 1 91 9 1
1  1   1  1  1    1   1  1   1
111111111111111111111111111111
1 51 6 1 61 71 81 8 1 91 91  1
1  1   1  1  1  1   1  1  1  1
111111111111111111111111111111
